111111111333333344444
101010101303440000004
100000001303000044004
100000001303440004004
101010101303000044004
100000000000000000004
222222222222222222004
400000000000000000004
440044004400440044004
100000000000000000004
101010101010101010101
101010101010101010101
100000000000000000001
222222222222222222222